i44444444i
4444444444
44iiiiii44
44i44i4i44
44i4444444
44i44i4i44
44iiiiii44
4444444444
i44444444i
iiiim4iiii