i44444444i
4i444444i4
4444444444
444iiii444
m44i44i444
444i44i444
444i44i444
4444444444
4i444444i4
i44444444i