i444444444
i44i4i4i44
i4ii444ii4
i444iii444
m4i4i4i4i4
44i44ri4i4
i444iii444
i4ii444ii4
i44i4i4i44
i444444444