m4i4444ii4
i4i4ii4444
4444444ii4
i4iii4ii44
44i444i44i
4iiii444ii
444444i4i4
ii4i4ii444
i44444i4i4
i4i4i4444l