4444444444
4iiiii4iii
44444i4i44
iii4ii4444
4444i4ii44
4i4ii4i4ii
4ii4i44444
4444ii4ii4
i4i44i4i44
444i444im4