m4i44444444444
44i4i4i4ii4ii4
ii44i4i4i444i4
4iii44iii44444
44444i44ii4iii
iiii4im4444444
444i4i44ii4ii4
444i4iiii44i44
i4ii4444i44i44
444iii44444ii4
4iii444iiii4ii
4i444i444i4444
4iiiiiii4i4im4
444444444i4444