l444iiii444444
4ii444444i4ii4
4i4iiiiiii4i44
444444444i4i44
iiii4iiiii4i44
44444il4444i44
ii4ii4iiiiiiii
m44444444i444i
ii4iiiii444i4i
44444i444i4444
4iii4i4i4iii4i
4444444i444444
4i4i4iii4i44l4
444444444i4444