44444444444444
4li4iiiiiii4l4
4ii4444444im44
44iiiiiii4iii4
44i444444444i4
44i4i4i4i4i4i4
44i44l44i4i4i4
44i4i4i4iiiii4
44i44444i44444
4iiiiiiiiiiii4
4li44444444il4
44444444444444