444444im44
4iii44iii4
4imi444444
4i4iii4ii4
4i44im44i4
4ii4iii4i4
4li444iii4
iiiii44mi4
4444iiiii4
m4i4444444