li4im444im
4i4iiii4i4
4i4444i4i4
4i4ii4i4i4
4i4i44i4i4
4i4i4mi4i4
4i4iiii4i4
4i444444i4
4iiiiiiii4
4444444444