4444444444
4iiiiii4l4
4il4444444
4iiii444i4
4444i444i4
4ii4iii4i4
ii4444i4i4
i444i4imi4
444ii4iii4
m4ii444444