0000000000000000000000000000000
000iiii0000000iiiiiiiii0iii0000
00ii44iiiiiiiii444i444iii4ii000
0ii4444ii4444i444444444i444ii00
0i444444ii44ii4444i4444i4i44i00
0i44i444i44444444iii44444444i00
0i444444i4444iiiii4iiiii4i44i00
0ii4444ii4444i444iii444i444ii00
00ii44ii44444ii4444444iii4ii700
000i4ii44iiiiiii44i44ii7i4i7700
000i44444i44444ii444ii777777000
000i4iiiii44444iii4ii7707770000
000i4i444i444444444i7700007a700
000i4i4i4i44444iii4ii7000000300
000i4i444i44444ii444i0007002300
000i4i4i4iiiiiii444ii07027a7000
000i4i444ii4444444ii00003300000
000i4i4i4i444iii4ii000700270000
000i4i444i44ii0iii0007707230700
000i4i4i4i4ii000000077007737700
000i4i444i4i000iii0000077227000
00ii4ii4ii4ii0ii4ii000773327700
0ii444i4i444iii444ii007ii4ii700
0i4444444444ii4jj44iiiii444i700
0i44i44ii444i44j44444444444i300
0i44444iii4iii4jj44iiiii444i300
0ii444ii0i4i0ii444ii002iiiii700
00ii4ii00i4i00ii4ii000772227700
000iii002i4i200iii0000077777000
000000022imi2200000000000000000
0000000000000000000000000000000