00000000000000000000000000000000000000000000000000000000000000000000000000000000000000000000000000000000000000000000000000000000
00000000000000000000000000000000000000000000000000000000000000000000000000000000000000000000000000000000000000000000000000000000
00000000000000000000000000000000000000000000000000000000000000000000000000000000000000000000000000000000000000000000000000000000
00000000000000000000000000000000000000000000000000000000000000000000000000000000000000000000000000000000000000000000000000000000
00000033333300000000000033333330000000000000003333333300000000000000000000000005555533300000000000000333333333300000000000000000
0000033335553300000000333333333330000000000033333366666666000000000000000000555555553n300000000011111116666633333330000000000000
00003383555553300000333333555553330000000003333335555566666600000000000000555555555333000000000111166666666663333333000000000000
00003555555555333333333335555555533000000003333355555555566660000000000005555555555110000000001116666666666666333333333000000000
00005555556666611133333355555555553300000033333555555555566666000000000005555555551110000000111666666666555555553333333300000000
00005555566666111113333355555555553333003333355555000555556666000000000055555555511100000001116666666655555555555533333330000000
00005556666611111111333555555555555533333333355550000055566660000000001115555555111000000066666666666555555555555553333330000000
00006666661111155551111555555555555333333333555555000666666600000000011155555555511100000006666666665555551111155555533333000000
00006666111155555555511155555555555553333335555550006666666600000000001115555555551110000066666666555555111555111555555333000000
00006666115555555555551155555577775555533333555555566666666000000000555111555555555511000066666666555551155555511555555533300000
00006633355555555555511155555777777555555333335555556666660000000005551111555555555551100006666666555555555585551155555555000000
00000033335555555555551115557777777755555533333555555566600000000005555111155555555551100000666666655555555555555555555555500000
00000003333355555555551111557777977755555333333555555566666000000055555111155555555555100000666666665555555555555555555555550000
00000000333333335555555111155777777755555533333355555556666600000555555511111155555555110000666666666655555555555555555555550000
00000000055553333355555511115557777555555553333555555556666330005555555551111115555555111000066666663333555555555555555555550000
00000000555553333335555555111555555555555533333355555555663330055555553333333111555555511100006666633333355555555555555550000000
00000000005533333335555553333555555555555533333555555555533330055553333333333331111555551110000055333333355555555555500000000000
00000005555553333333555533333555555555555333335555555555333333003333333333333333311155555111005553333333555555551111000000000000
00000055555555533333333333335555555555555333333555555553333333300333333333333333331111555500055553333333555511111155550000000000
0000005555555553333333333333555555555555553333335555553333333333a333333555555333333111155555555533333335511111115557777000000000
00000555555555553333333333333355555555555533333335553333333333330033335555555533333311111111115503333355111115555577777770000000
00005555555555553333333333333335555555555333333333333333333333333033355555555553333355111111111003333351111117777777777777000000
00005555555555555333333333333666655555553333333333333333333333333033555556666555333555555566600000333331111177777777777777770000
00005555555555555533333330006666666555533333333333333355553333333005555666666555533355555666660000333333111777777777755777770000
00005555555555555553333000000066666655553333333333555555555333333300555666666655553333556666666000033333333777777777555577770000
00005555555555555555330000000006666655553333333355555555556663333330055566666665555333333666666600003333333777777777555577770000
00005555555555555555500000000006666555533333333555555555566666633333005556666655555333333355555550003333333777777777755777770000
00000055555555555555500000000011155555533333335555555555666666663333300000555555555533333555555500000333333377777777777777700000
00000005555555555555000000000111111155333333555555555555666666666333333300000555555553333355555000003333333337777777777777000000
00000000000055555550000001111111111113333333555555555555566666666333311110000055555553333335550000033333333333777777777770000000
00000000666000555500000111111111111111333335555555551111116666663331111100000005555555333333000000333333333333337777777000000000
0000000666666a550001111111111111111133333355555551111111111666666111111000000000555555333333300000033333333333336666660000000000
00000066666660000066661111111111113333333335551111111111111166666111111100000005555553333333300000003333333333666666666600000000
00000066666666666666666661111111333333333333111111166661111115551111111110000055555555333333330000033333333336666666655550000000
00000066666666666666666666611113333333333331111666666666661155555555551111000555555555533333333000333333333366666665555555000000
00000006666666666333366666661133333333333333666666666666666115555577777111111155555555333333333003333333333666666655555555500000
00000000666555533333333666660033333333333335555555666666661111557777777771111115555553333333330033333111166666666555555555550000
0000005555555533333333336660000333333333335555555555566666611117777777772225555555553333333333a333551111116666665555555555500000
00000555555533333333333666600000333333335555555555555566666666000077777222225555555553333330000555551111111666655555555555500000
00005555555333333333355555000003333333355555555555555333366660000000022222222555555533330000000555555551111166555555555555000000
00005555533333333355555550000003333333555555555553333333333000000000222222225555555000000000000055555222111155555555555550000000
00005555333333355555555000000000333333355555553333338333330000000000002222255555500000000000000000222222221111155555500000000000
00005555533333555550000000000333333333335555333333333000000000000000000005555500000000000000000000000222222111111100000000000000
00000555553335555000000000003333333333333333333b33300000000000000000000000000000000000000000000000000002222222111000000000000000
00000055555555550000000003333333333333333333333330000000000000000000000000000000000000000000000000000000000292110000000000000000
00000055555555500000000055555533333333333333333000000001110000000000000000000000000000000555555000000000000000000000000000000000
00000000555555555000000555555553333333333333300000000111111000000000000000000000000555555555553333300000000000000000000666600000
00000005555555555500000000555555533333333333000000022211111110000000000000000055555555555555533333333300000000000000006666660000
0000005555555555555000000005555555533333333000000012b211111111000000000000077775555555555555533333333333300000000000066666660000
00000005555555555500000000005555555533333333000001122277111111100777a77700777777755555555555553333333333333292000000666666660000
00000005555555555111100000555555555553333333000011111117711117777770000777777777775555555555555533333333333222000005555666660000
00000000055555511111111111115555555533333333000001111777711177777110000117777777777555555555555555553333336666660055555555550000
00000000335511111111111111111555555553333330000011117777111117771100000011177777777775555555555555551116666666666555555555550000
00000033331111111111111111111155555555333300000011777777711111711000000001111777777777555555500001111116666666665555555555550000
00000333311115555555111111111111155555666000000001117777771111661100000000011177777777555550000000111111166666666555555555550000
00003333111555555555511111111111111555566600000000117777771116611100000000001111777775555000000001111111111111666555555555550000
00003333555555522225555111111111111155556660000000117777711166611000000000000011166666555500001111555551111111155555555555500000
00003335555552222222555551111333391155566660000000111777111666611000000000000011666666665555555555555555111111111155555550000000
00003333555522222222555555333333111666666660000000011771116666661100000000000111666666665555555555555555111111111777555500000000
00003335555552222225555555333331116666666600000000011211111161111100000000000011666666333333333555555551111111177777755000000000
00003335555555222255555553333331111666666000000000112211111333111000000000000001166663333333333333355555555555777777775500000000
00003335555555555555555511111111111111100000000000011221113331110000000000000011166633333333333333335555555557777777755550000000
00003333555555555555551111111111155550000000000000001122111333111000000000000001116663333333333333335555555555777777555550000000
00000333355555555566611111155555555533000000000000001122221133311000000000000000111666666665553333355555555555577775555555000000
00000033335555555666666111555555555333330000000000000112222221110000000000000000011666666655555333555511111111555555555555500000
00000000333355555555666665555555553333333000000000000011122111000000000000000000000066666555555555551113333311111155555555550000
00000000003333555555566666655555333333330000000000000000111100000000000000000000000000555555555555511133333333311115555555550000
00000000000333335555556665555553333333300000000000000000000000000000000000000000000000005555555555511333555553331111155555550000
00000000000033333355555555555533333330000055555550000000000000000000000000000000000000000055555555333335555555333311155555550000
00000000000003333335555555555333330000005555555000000000000000000000000000000000000000005555555553333355000005533331115555550000
00000000000000033333355555555333333000033555550000000000000000000000000000000000000000555555555533333550000000553331155555550000
00000000000000003333333555555553333333333355500000000000000000000000000000000000000000055555555553335500033300055331115555550000
000000000000000000333333555555555333333333300000000000000000000000000000000000000000000000555555553355000383aaa55331155555550000
00000000001111110000000005555555555553333000000000000000000000000000000000000000000000000555555555555500033300055331155555550000
00000000011155555500000000055555555555333300000000000000000000000000000000000000000000000055555555555550000000553311555555500000
00000000111555555555500000555555555553333330000000000000000000000000000000111111110000000005555555555555000005551111555555000000
00000001115555555533330000005555555533333333330000000000000000000000000011111777777700000000055555555511111555555555555555000000
00000011155555533333333330000555555533333333333000000000000000000000000777777771111770000000555555555551111155555555555550000000
00000111555555333333333333305555555333333553333300000000000000000000001111111111111177000000055555555555511116665555555533000000
000011155553333333335555333a5555555333335555333330000000000000011111111117777771111117000000000555555555551116666555555333330000
00001115553333333355555555500555553333355555533330000000000011111111777777777777771117110000005555555555555511666555553333330000
00001155555333335555555555530055553333555555553333000000001111111117711111111111177117110000000555555555555551166655555333330000
00005555533333366555555555551111555333355555533333000000011111111177111177777777117117111000000005555555555555116655555333330000
00005555333333666655555555511111111333335555333333000000001111111171111111117771117717111100000005555555555555111665555533330000
00005555533336666555555555111111111113333333333330000000000066777771111111111711111777711100000000555555555555511666555553300000
00005555533666665555555551111111111111133333333000000000006666611177111111111711111111511110000000055555555555551155555555000000
00000055555666666555551111177777771111111333300000000055566666661117777711111711111115551110000000000055555555666655555555000000
00000005555566666655111777777777777111110000000000000555556666611111111111111777777755555111000000000000555556666655555555000000
00000055555566666666677777777777777711100000000000055555566666611111113331111111111555555511000000000000055555566665555550000000
00005555555556666666777777777877777110000000000005555556666666611555333300001111111155555110000000000000005555556666555000000000
00005555555555566666777777777777770000005555555555555666666666115555533333000222221111551100000000000000555555566666655500000000
00000555555555555667777777777770000000555555500000006666666111155555533333a22222333311150000000000000000055555556666555550000000
00000000055555555577777777777000000055550000555555666666611155555555553330022223333331133000000000000000055555556665555500000000
00000000000000055777777777777700000555555550000000066666115555555555500002222233333311113300000000000000005555666655555000000000
00000000000077777777777777700000000005555555555555556661155555555000000022222333333111113000000000000005500555566665555500000000
00000000777777777777777777777000005555555500005555555111555550000000000002223333333551133300000000000055550555556655555000000000
00000077777766666677777777777555550000000000000555511155555000000000000033333333333555113330000000000555550055555555550000000000
00000007776666555557777777775555555555555550005551155555550000000000055553333333335555511133000000000005555005555555550000000000
00000066666655555555557777755555555555555555a55111555555500000005555555555333333355555555113300000000055555500555555500000000000
0000066666555555555555557777555555555555550000115555333300000000005555555553333355555555113330000000005525555a555555000000000000
000066666665555555555555577775555555555500000000033333300000000005555555555ii3ii555555511113330000000552225550055550000000000000
000066666111155555555555577777555555500000000000333333000000000000555555555i333i555555511111333000000555222550055500000000000000
000066666611111555555555777777755555511000011111333333000000000000005555555i383i555555551111166600000055522555000000000000000000
000066666666111115555555777777775555511100111155333330033330000000000055555i333i555555555511666660000055333355500000000000000000
00006666666111111111555577777777665555111111155553333a333335555500000005555iiiii555555555111666666000005533366663330000000000000
00006666666115555511111117777766666655511111555553330033335555555555111155555555555555551116666660000000033666666633333300000000
00000666661155555555111111177666666661111115555555000555333335555555511111155555555551111116666600000000006661111166633333000000
00000006661155555333331111666666666666111111555550005555533333355555555111111115555111111166666660000000066611155111663333000000
00000000066115553333333666666666666611111115555500055555553333335555555511111111111111111666666666000000666111555511666300000000
0000000066661113333333666666666666611111115555500005555553333333335555522211111111111222226666660000000666111555n551133000000000
00000006666611333333333666666666611111155555555000005555333333333355522222222111111122222226666660000000666115555511113333000000
00000000666611333333333366666666111111555555555000055555333333333355522222222211111222222222666600000000066611555511666333000000
00000000066666333333333366666666611115555555550000005555533333333555222222222221112222222222266000000000066611151116663330000000
00000000000666633333333666666661111155555555500000005555555333333555522222222222222222222222220000000000006661151166633300000000
00000000006666663333336666000111111115555555000000000555555553335555522222222222002222222222200000000000006666666663333000000000
00000000000666666333366660000055555555555550000000000005555555555555222222222220000222222222000000000000006666662220000000000000
00000000000066666666666666000555555555555000000000000000055555555552222222222200000000222200000000000000000666622000000000000000
00000000000006666666666666a63666655555000000000000000000000555552222222222222000000000000000000000000000000066220000000000000000
00000000000000066666666660006666666000000000000000000000000000022222222222220000000000000000000000000000000022220000000000000000
00000000000000006666666000000000000000000000000000000000000000002222222222000000000000000000000000000000000022200000000000000000
00000000000000000000000000000000000000000000000000000000000000000000000000000000000000000000000000000000000000000000000000000000
00000000000000000000000000000000000000000000000000000000000000000000000000000000000000000000000000000000000000000000000000000000
00000000000000000000000000000000000000000000000000000000000000000000000000000000000000000000000000000000000000000000000000000000
00000000000000000000000000000000000000000000000000000000000000000000000000000000000000000000000000000000000000000000000000000000